1 19 26 26 26 26 18 26 26 26 26 26 22  0  0 19 26 26 26 26 26 18 26 26 26 26 22 4
1 21  0  0  0  0 37  0  0  0  0  0 21  0  0 21  0  0  0  0  0 37  0  0  0  0 21 4
1 21  0  0  0  0 21  0  0  0  0  0 21  0  0 21  0  0  0  0  0 21  0  0  0  0 21 4
1 17 26 26 26 26 16 26 26 18 26 26 24 26 26 24 26 26 18 26 26 16 26 26 26 26 20 4
1 21  0  0  0  0 21  0  0 21  0  0  0  0  0  0  0  0 21  0  0 21  0  0  0  0 21 4
1 21  0  0  0  0 21  0  0 21  0  0  0  0  0  0  0  0 21  0  0 21  0  0  0  0 21 4
1 17 26 26 26 26 16 26 26 24 26 26 22  0  0 19 26 26 24 26 26 16 26 26 26 26 20 4
1 21  0  0  0  0 21  0  0  0  0  0 21  0  0 21  0  0  0  0  0 21  0  0  0  0 21 4
1 21  0  0  0  0 21  0  0  0  0  0 21  0  0 21  0  0  0  0  0 21  0  0  0  0 21 4
1 21  0  0  0  0 21  0  0 19 26 26 24 26 26 24 26 26 22  0  0 21  0  0  0  0 21 4
1 21  0  0  0  0 21  0  0 21  0  0  0  0  0  0  0  0 21  0  0 21  0  0  0  0 21 4
1 21  0  0  0  0 21  0  0 21  0  0  0  0  0  0  0  0 21  0  0 21  0  0  0  0 21 4
1 17 26 26 26 26 16 26 26 20  0  0  0  0  0  0  0  0 17 26 26 16 26 26 26 26 20 4
1 21  0  0  0  0 21  0  0 21  0  0  0  0  0  0  0  0 21  0  0 21  0  0  0  0 21 4
1 21  0  0  0  0 21  0  0 21  0  0  0  0  0  0  0  0 21  0  0 21  0  0  0  0 21 4
1 21  0  0  0  0 21  0  0 17 26 26 26 26 26 26 26 26 20  0  0 21  0  0  0  0 21 4
1 21  0  0  0  0 21  0  0 21  0  0  0  0  0  0  0  0 21  0  0 21  0  0  0  0 21 4
1 21  0  0  0  0 21  0  0 21  0  0  0  0  0  0  0  0 21  0  0 21  0  0  0  0 21 4
1 17 26 26 26 26 16 26 26 24 26 26 22  0  0 19 26 26 24 26 26 16 26 26 26 26 20 4
1 21  0  0  0  0 21  0  0  0  0  0 21  0  0 21  0  0  0  0  0 21  0  0  0  0 21 4
1 21  0  0  0  0 21  0  0  0  0  0 21  0  0 21  0  0  0  0  0 21  0  0  0  0 21 4
1 25 26 18 26 26 16 26 26 18 26 26 24 26 26 24 26 26 18 26 26 16 26 26 18 26 28 4
1  0  0 21  0  0 21  0  0 21  0  0  0  0  0  0  0  0 21  0  0 21  0  0 21  0  0 4
1  0  0 21  0  0 37  0  0 21  0  0  0  0  0  0  0  0 21  0  0 37  0  0 21  0  0 4
1 19 26 24 26 26 28  0  0 25 26 26 18 26 26 18 26 26 28  0  0 25 26 26 24 26 22 4
1 21  0  0  0  0  0  0  0  0  0  0 21  0  0 21  0  0  0  0  0  0  0  0  0  0 21 4
1 21  0  0  0  0  0  0  0  0  0  0 21  0  0 21  0  0  0  0  0  0  0  0  0  0 21 4
1 25 26 26 26 26 26 26 26 26 26 26 24 26 26 24 26 26 26 26 26 26 26 26 26 26 28 4